25,70,0,0,0,0,0,0,0,0,0
5,45,2,2,2,2,0,0,0,0,0
5,60,0,0,0,0,2,2.5,0,0,0
6,50,3,3,1,6,0,0,0,0,0
5,50,0,0,0,0,7,7,20,160,2
8,60,6,9,8,3,0,0,40,90,1
8,40,1,3,1,5,3,4,20,80,3
8,60,0,0,0,0,10,10,30,100,2
